20 15
2 2 2 2 2 2 2 2 2 2 5 5 5 5 5 5 5 5 5 5 
2 0 0 0 2 2 0 0 0 2 5 5 5 5 5 5 5 5 5 5
2 0 0 0 2 2 0 0 0 2 5 5 5 5 5 5 5 5 5 5
2 0 0 0 2 2 0 0 0 2 2 2 2 2 2 2 2 2 2 2
2 0 0 0 0 0 0 0 0 0 0 0 0 0 0 0 0 0 0 2
2 0 0 0 0 0 0 0 0 0 0 0 0 0 0 0 0 0 0 2
2 0 0 0 0 0 0 0 0 2 2 2 2 2 2 2 2 2 2 2
2 0 0 0 0 0 0 0 0 2 5 5 5 5 5 5 5 5 5 5
2 0 0 0 0 0 0 0 0 2 5 5 5 5 5 5 5 5 5 5
2 2 2 2 0 0 2 2 2 2 5 5 5 5 5 5 5 5 5 5 
5 5 5 2 0 0 2 5 5 5 5 5 5 5 5 5 5 5 5 5
5 5 5 2 0 0 2 2 2 2 5 5 5 5 5 5 5 5 5 5 
5 5 5 2 0 0 0 0 0 2 5 5 5 5 5 5 5 5 5 5
5 5 5 2 0 0 0 0 0 2 5 5 5 5 5 5 5 5 5 5
5 5 5 2 2 2 2 2 2 2 5 5 5 5 5 5 5 5 5 5
 

